Reddit_Username	Twitter_Username
stephenkinghere	StephenKing
imdavidarquette	DavidArquette
Official_THR	TheFienPrint
ChrisHansen_Official	chrishansen
IAMGilbert_Gottfried	RealGilbert
SarahCallies	SarahWCallies
_Gordon_Ramsay	GordonRamsay
TheRealLeahRemini	LeahRemini
ryancreamerPH	ryguyguyry
thealtonbrown	altonbrown
IronChefOfForensics	Ed_Primeau
RayTDalio	RayDalio
raanster	raanstermonster
AskEnglishHeritage	EnglishHeritage
thepoliticalrev	meredith_2020
tobymuse	tobymuse
olgakhazan	olgakhazan
Shawnjohnsoneast	ShawnJohnson
ufexplore	ErinWestgate
itspeterj	icanstealthat
PreacherLawson	PreacherLawson
Lisa_Arch	flawless_mom
B_Lustmord	Lustmord
SimplyAJ10	SimplyAJ10
realAlinaLopez	ItsAlinaLopez
RachelDeAlto	RachelDeAlto
thisisbillgates	BillGates
bernie-sanders	BernieSanders
janegoodall_official	JaneGoodallInst
AndrewyangUBI	AndrewYang
ElonMuskOfficial	elonmusk
Tyree07	LlysseWylle
Official_FCC_CJR	JRosenworcel
sundialbill	BillNye
MacaulayCulkinAMA	IncredibleCulk
ChrisPrattOfficial	prattprattpratt
georgeclintonpfunk	george_clinton
mistersavage	donttrythis
The_Conan_Obrien	ConanOBrien
MaxBrooksAuthor	maxbrooksauthor
TheSteveWozniak	stevewoz
JimOHeir	JimOHeir
GarySiniseOfficial	GarySinise
NickOfferman	Nick_Offerman
hitrecordjoe_	hitRECordJoe
MichaelMando	MandoMichael
Amanda_Murdock	amandamurd0ck
Steve_DeAngelo	stevedeangelo
gage-allen	Lotims
TexasRocketLab	texasrocketlab
noredavisStandUpKid	noredavis
zarkonnen	zarkonnen_com
GettingPhysicl	IowaQuinn
Chtorrr	NASAUniverse
nathan_j_robinson	curaffairs
PhilipsNorelco	FellowBarber
theintercept	marahvistendahl
kgpmn	kpottermn
USAFacts_Official	USAFacts
Common_Cause	CommonCause
ledewriter	SpyTalker
YahooSports	YahooSportsbook
LMarantz	LarissaMarantz
arenasnow	seanwrona
PodTherapy	PodTherapyGuys
CatchTheseWords	catchthesewords
Art4MAD	art4mad
WillieHilliardRVA	williefor3rd
zackexley	zackexley
handonovan	gotrealpod
mattwridley	mattwridley
Jemoka	condution
HomiesForHydration	HydrationHomies
ky_hunter	EndFamilyFire
marli01	93Marla
socalguitar	62MileClub
shinebarlow	TiffanieD
LolaRuin	LolaRuin
npr	NPRLifeKit
PhoenixCongress	PhoenixCongress
JJBHairLooks	J__J__B
ImperialCollege	ImperialSpark
FunkTurkey	FunkTurkey
CampaignForUyghurs	CUyghurs
politico	politico
JaronRMJohnson	actionfiction
VibrAlign	VibrAlign
APnews	AP
TakeTheWheel11	dafedidi
erikwil_xxx	ErikWil_XXX
DevotedToNeurosis	crowns_dev
ShanBoodyInaPark_YMT	InfoASHA
nickfurlong	itsnickfurlong
LiveWithEarth	RangelRicardo_
forbes	TheAlexKnapp
pintofscienceau	pintofscienceAU
MelvilleHouse	m_scribe
thelucidteam	thelucidproject
HCRWealthAdvisors	HcrWealth
GettingPhysicl	Hughes4GA
prhauthors	colindickey
ufexplore	UFExplore
Tech4GS	woodyatpch
dandrezner	dandrezner
the_mit_press	DeathRef
bumblebear_games	bumblebeargames
KurtKohlstedt	99piorg
trai_dep	micahflee
annieplaysguitar	annieplayguitar
HammForSenate	HammForSenate
LostSymphonyMusic	lostsymphony1
thenewyorktimes	karaswisher
myanrueller	myanrueller28
loladiro	KenoFischer
theexterminat	ChiefRaconteur
ameliag	AmeliaG
CapnBecki	capnbecki
agentadventure	bang_twts
PaulLeonardMorgan	PaulLeonardMorg
toddspoth	toddspoth
TheSarahBolger	sarahbolger
mrphs	kandoo_tech
TomONeillAuthorCHAOS	chaosmansonbook
lonnib	lonnibesancon
DailyDoseOfInternet_	ddofinternet
prhauthors	Matt_Alt
lionrock_recovery	lionrock_life
OfficialLyndaCarter	RealLyndaCarter
PenguinRandomHouse	sfdirewolf
SzymonKrukowski	SUPERHOTTHEGAME
Sersch	moi_rai_
FREEZX	KTrajkovski
medivizor	medivizor
AlexNorthWriter	writer_north
wallowsmusic	wallowsmusic
N8theGr8	reuters
officialbillystrings	BillyStrings
RossonWheel	Rossel64
WaQuakePrepare	waEMD
theeconomist	ECONdailycharts
mashable	mashable
CrassostreaVirginica	benhovland
Virtual_Dan	FMF_365
drlauriesantos	lauriesantos
GettingPhysicl	DabbsforD52
thepoliticalrev	OurPoliticalRev
AndrewJuan04	AndrewDJuan
AdamWittRN	HMHNewJersey
armbrustUSA	larmbrust
Crytivo	Crytivo
Maydays_Fallout	MackWithMast
AONomad	BaldingsWorld
LL_Redux	TexasTribune
sketchup	SketchUp
itspeterj	itspeterj
mrcchapman	ChemistryKit
Ellie_D	polarben
reuters	juliocesrchavez
jeremyburge	jeremyburge
WorldsToughestRace	ToughRaceTV
TwoFeathersVGM	BjorkmanElvira
selinker	mikeselinker
reuters	reuters
patriotact	patriotact
CPRnews	CPRNews
GettingPhysicl	Travis4TX
1daysoonervolunteers	1daysooner
ImperialCollege	imperialcollege
thepoliticalrev	melforprogress
gage-allen	lotims
TeamNutaku	nutakugames
hinoyminoy69	billythebutcher
NoelAlejandroFilms	noelalejandrox
GettingPhysicl	votelopezfor77
TwoCentsPBS	TwoCentsPBS
WATLofficial	WATLaxe
watchvenn	watchvenn
emilyanthes	emilyanthes
webmd	WebMD
throwbecausenaked	felidaegw
meteoritemarina	meteoritemarina
teamameelio	teamameelio
surajpatelnyc	surajpatelnyc
Dr_David_Eagleman	davideagleman
tmattorney	IRegisterTMs
realJaneWilde	janewildexxx
BaOui	baouiapp
WorldThrombosisDay	MaryCushmanMD
DukeSciSoc-Ben	dukesci_soc
zav42	EGOSOFT
Hyper_Wave	hyperwavemusic
UnsightlyOpinions	UnsightlyOp
Kyle__MacLachlan	Kyle_MacLachlan
BallotReady	BallotReady
MyHomelessMeals	MyHomelessMeals
UniOfManchester	BBCBreakfast
Rob-Transom	Transom_org
csm_reporter	samlaineperfas
writerlr	rileylroberts
smpr20	THPSfilm
some_oceanographer	earthinstitute
cannabiseduresearch1	ProfDanBear
BusinessCreditCassie	thatcassieprice
GettingPhysicl	bradshaw2020
snarlynarwhal	HalfHumanGames
rejusten	justen
CelSci	CelSciCorp
JoyceGriggs2020	JoyceGriggs2020
Kirtaner-420chan	Kirtaner
myqkaplan	myqkaplan
AlexFromActTV	AlexCequea
helloalphamd	helloalphamd
ZAWGURN	RebeccaforWA
techcongress	congressfellows
mindfulphysician	GailGazelleMD
LL_Redux	CA4equalrights
Ngthatsme	threehourcoffee
MichaelLewis-Mycroft	mycroft_ai
OrientalInstitute	orientalinst
Steve_Alpert_Ghibli	StoneBridgePub
CandelaCoin	CandelaCoin
jewelzblu	jewelz_blu
JediMasterNiko	lemmiwinks_iii
nationalgeographic	AAlechiarenza
geekteam6	helm_ai
rightcoastguy	mattyxb
ZachForND	zachfornd
Matingas	Matingas
SecDef19	SecDef19
boomzap	boomzap
CrassostreaVirginica	rjmarr
winglett	_winglett
Georgy_K_Zhukov	e_c_roberts
andrewdgold	AndrewGold_ok
wiczipedia	wiczipedia
DeckardCorporation	DeckardCorp
Inside_Higher_Ed	insidehighered
sarahlipson	BUexperts
defnotsiri	therealsirips
JesseNeugarten	DollarFlights
Sabrinanichole	sabrinanichol
nypost	jakebrownradio
washingtonpost	dataeditor
FinolaAustinWriter	SVictorianist
ShannonFabert2020	Fabert2020
Michaelwellison	MichaelwEllison
ICIJ	spencerwoodman
cqwww	cqwww
Drugs_and_Mirrors	tom_aspaul
SanfordAuerbach	BUexperts
themaintainers	STS_News
SanjayM	E3DOnline
Rheaply	RheaplyInc
joshduffney	joshduffney
ImperialCollege	AnnaBlakney
Power_Burger	LifeIncGame
AirspeederGrandPrix	airspeederhq
ONEcondoms	ONECondoms
realPaytonPreslee	PAYTONPRESLEE
UnrealFehr	unrealfehr
Backup_Jon	VeritasTechLLC
reuters	Reuters
cbcnews	shephardm
dr-akhter	murtazaakhter
SleepPhones_Team	SleepPhones
dragonslumber	dragon_slumber
HeroForgeMinis	HeroForgeMinis
TomTom_developers	TomTomDevs
Danfilmman	DAN_LOTZ
jmdm63	SvenvandeWege
GettingPhysicl	EmilySkopovPA
Ren_Dem	FollowFeathers
ChelseaRustad	chelseagrustad
awkwardmike	awkwardfamily
NewsLitProject	BrandyZadrozny
injusticewatch	injusticewatch
StripTheLabelKY	MikeForKY
Blue59	PlayAlluris
thisisinsider	anthony_delcol
israelbobsled	bobsleddr
thepoliticalrev	JENFL23
DrPragyaAgarwal	drpragyaagarwal
Jozef-Youssef	jozef_youssef
lionrock_recovery	lionrock_rcvy
whyohwhy115	MAXMusic
thedebtreliefco	DebtReliefCo
Policygenius	Policygenius
kristendhowerton	kristenhowerton
GettingPhysicl	NickforPA
SpyInTheWild	MattGordonUK
MadelineMiller	MillerMadeline
NFxDoc17	IkeUnsal
BusinessInsider	notsoTan_za
AdamBandt	AdamBandt
justinlehmiller	JustinLehmiller
realCaliCarter	MissCaliCarter
realKenzieMadison	KenzieMadisonxX
firemichelmoore	23rdButterfly
nasa	NASAInterns
gekogekogeko	sgcarney
jawn317	shaun_gallagher
nitoso	EternalStew
matthewrodier	mattrodierphot1
lonnib	LeyClem
Betsy514	betsy514
annehelenpetersen	annehelen
matthewrojansky	kennaninstitute
nickfurlong	rasofficial
sarbjit_smarkets	Sarbjit_pol
Andromeda321	whereisyvette
SorenJohnsonMohawk	SorenJohnson
OzFreelancer	EileenOrmsby
Katy-L-Wood	DeepTimeFossils
TTRABoard	JennyRockus
Kaspersky_GReAT	craiu
awesemo	Awesemo_Com
thepoliticalrev	DemSocialists
anxiousholiday	LiLYLABEAU
cedricbabouche	Cedric_Babouche
theauthsource	MOUGK
nnomadic	LizzieJones42
starz	STARZ
myglesias	mattyglesias
OfficialPervCity	pervcity
NicTailorXPCF	DrAdamMurphy
Georgy_K_Zhukov	rauchway
PMBreakingNews	PMBreakingNews
Roie_Galitz	galitz
GettingPhysicl	MicheleKnoll44
sm_frost	WilliamLMeadows
breemarie99	themazterlives
PuppetKitchen	puppetkitchen
Overwolf_CEO	TheOverwolf
RoyalFino	OrcsMustDie
CEOUNICOM	abine
ACLU-Washington	jennifer_e_lee
Neurowellness	neurowellness
doodlebytes	forrestbrazeal
jbariso	JustinJBariso
MARFORCYBER	MARFORCYBER
ArgonneLab	argonne
Tyree07	BethDoglio
jawanda	philmosbyphoto
usatoday	DaphneChen_
geoffmk	geoffkeighley
ProfHansNoel	ProfHansNoel
VisorpantsJon	Rinemania
westernu	datingdecisions
typicalchinesefood	MonarchWill
groovyduderecords	groovyduderecs
Bartgellman	bartongellman
Dr_Cam	DrSepah
climatelawgeek	Discovery
Dr_Midnight	emilyopilo
politico	morningmoneyben
warriorsgamingsquad	MikeChec1__2
financialtimes	tmjennings
GettingPhysicl	brendantjohnson
ivanhoe90	photopeacom
mmm_toasty	DrMonnica
SkaPlunk	NeuroGum
MrJonLott	howey_ou
shakamone	SideQuestVR
BillCorbett	BillCorbett
SuperBounceGames	SuperBounceGame
RecallDurkan	recall_durkan
realPaigeOwens	PaigeOwensXXX
GettingPhysicl	CelinaforTexas
Spagetti13	SpataTimes
techreview	techreview
usatoday	eweise
thesaltlaketribune	sltrib
jsnake24007	jbeardmusic
ConstantGoose	EmilyBeyda
reuters	lawrencehurley
iamthatis	NSSPCA
TheDeepEndGames	GameOnGardner